Player,Team,GP,G,A,Pts,PIM
Tyler Seguin,Plymouth Whalers,63,48,58,106,54
Taylor Hall,Windsor Spitfires,57,40,66,106,56
Luke Pither,Barrie Colts,67,36,58,94,44
Taylor Beck,Guelph Storm,61,39,54,93,54
Nazem Kadri,London Knights,56,35,58,93,105
Zack Torquato,Erie Otters,68,31,62,93,72
Jeff Skinner,Kitchener Rangers,64,50,40,90,72
Chris MacKinnon,Kitchener Rangers,64,29,61,90,78
Jordan Skellett,Saginaw Spirit,66,26,62,88,16
Mike Cazzola,Erie Otters,68,36,50,86,74
